0000100000
0000100000
0000100000
0022122000
0022122000
1111111111
0022122000
0022122000
0000100000
0000100000