00000000100000000000
00000000100000000000
00000000100000100000
00000000100000000000
00000000100000000000
00000000100000000000
00000000100000000000
00000000100000000000
11111111111111111111
11111111111111111111